00 00 00 10 03 03 03 03 03 03 03 08 08 08 08 03
00 11 04 03 03 03 03 03 08 08 07 00 00 00 00 10
00 09 08 03 03 08 03 06 00 00 00 00 11 05 00 10
00 00 00 09 07 00 10 06 00 11 05 00 09 07 00 10
04 05 00 00 00 00 09 07 00 09 07 00 00 00 00 10
03 06 00 11 05 00 00 00 00 00 00 00 11 04 04 03
03 03 04 03 06 00 11 05 00 11 05 00 10 03 08 03
03 03 03 03 06 00 09 07 00 10 06 00 10 06 00 10
03 03 03 03 06 00 00 00 00 10 06 00 09 07 00 10
03 03 03 03 03 04 04 05 00 10 06 00 00 00 00 10
03 03 03 03 03 03 03 03 04 03 03 04 04 04 04 03
03 03 03 03 03 03 03 03 03 03 03 03 03 03 03 03