00 00 00 00 10 03 03 03 03 03 03 03 08 08 08 08
00 11 05 00 10 03 03 03 03 03 03 06 00 00 00 00
00 09 07 00 10 03 03 03 03 03 03 06 00 11 04 04
00 00 00 00 10 03 00 10 03 03 03 06 00 00 00 00
04 04 05 00 10 06 00 10 03 08 08 07 00 11 04 04
04 04 06 00 09 07 00 10 06 00 00 00 00 00 00 00
08 08 07 00 00 00 00 09 07 00 09 07 00 11 04 04
00 00 00 00 05 00 00 00 00 00 10 06 00 10 03 03
04 05 00 11 10 00 11 05 00 00 10 03 00 10 03 03
07 00 11 08 10 00 09 07 00 11 03 03 04 03 03 03
00 00 00 00 10 00 00 00 00 00 03 03 03 03 03 03
