02 02 02 03 03 03 03 03 03 03 03 03 03 03 03 03
02 03 03 02 03 02 03 02 02 03 03 02 03 03 02 02
02 03 03 02 03 02 03 02 03 02 03 02 03 02 02 03
02 03 03 02 02 02 03 02 02 02 03 02 03 03 03 02
02 02 02 02 03 02 02 02 03 02 02 02 02 02 02 02
03 03 03 03 03 03 03 03 03 03 03 03 03 03 03 03
03 03 03 03 03 03 03 03 03 03 03 03 03 03 03 03
03 03 03 03 03 03 03 03 03 03 03 03 03 03 03 03
03 03 03 03 03 03 03 03 03 03 03 03 03 03 03 03
03 03 03 03 03 03 03 03 03 03 03 03 03 03 03 03
03 03 03 03 03 03 03 03 03 03 03 03 03 03 03 03
03 03 03 03 03 03 03 03 03 03 03 03 03 03 03 03
